7 15
001000000000000
101011111111110
101000000000010
101111111111010
100000000000010
111111111111110
100000000000000