5 21
011111111111111111111
000000000001111111111
111100110301111111111
111111110000000000000
111111111111111111110